1961:
Девчата - Юрий Чулюкин (смотреть бесплатно)
Двенадцать спутников - Эразм Карамян
Полосатый рейс - Владимир Фетин (смотреть бесплатно)
Странная история - Шуа Шейхов
Мир входящему - Александр Алов, Владимир Наумов
Космонавт №… - Тамара Лисицианa
Планета бурь - Павел Клушанцев
Отвергнутая невеста - Юлдаш Агзамов
Алёнка - Борис Барнет
Рассказ нищего - Лео Эсакия
Чужие - Марионас Гедрис
Суд сумасшедших - Григорий Рошаль
В трудный час - Илья Гурин (смотреть бесплатно)
Чужой бумажник - Глеб Комаровский
Високосный год - Анатолий Эфрос
Наш общий друг - Иван Пырьев
Вольный ветер - Леонид Трауберг, Андрей Тутышкин
Девчонка, с которой я дружил - Николай Лебедев
Евдокия - Татьяна Лиознова
Иван Рыбаков - Борис Равенских, Елена Скачко
За двумя зайцами - Виктор Иванов
Последние залпы - Леон Сааков
Девять дней одного года - Михаил Ромм
Парни одной деревни - Юри Мююр
Укрощение строптивой - Сергей Колосов
Своя голова на плечах - Мария Федорова
Человек идёт за солнцем - Михаил Калик
Украинская рапсодия - Сергей Параджанов
Совершенно серьёзно
Костры горят - Юрий Кавтарадзе
Мой друг, Колька!… - Александр Митта, Алексей Салтыков
Перед рассветом - Григорий Мелик-Авакян
Карьера Димы Горина - Фрунзе Довлатян, Лев Мирский
Орлиный остров - Михаил Израилев, Марианна Рошаль
Осторожно, бабушка! - Надежда Кошеверова
И снова утро - Геннадий Казанский
Дерсу Узала - Агаси Бабаян
Отть в космосе - Эльберт Туганов
Лесная песня - Виктор Ивченко
Иванна - Виктор Ивченко
Нахалёнок - Евгений Карелов
Барьер неизвестности - Никита Курихин
Человек ниоткуда - Эльдар Рязанов
Самые первые - Анатолий Граник
Опасные повороты - Кальё Кийск, Юлий Кун
Ночной пассажир - Манос Захариас
Старожил - Искандер Хамраев
Зелёный патруль - Глеб Нифонтов
Казаки - Василий Пронин
Знамя кузнеца - Борис Кимягаров
Маленькие истории о детях, которые… - Али Хамраев
Канонада - Раймондас Вабалас, Арунас Жебрюнас
Командировка - Юрий Егоров
Тучи над Борском - Василий Ордынский
Жених без диплома - Леван Хотивари
Василий Докучаев - Андрей Чигинский
С днём рождения - Мечислава Маевская, Алексей Маслюков
Чёртова дюжина - Павел Арманд
Битва в пути - Владимир Басов
Дуэль - Татьяна Березанцева, Лев Рудник
Наша улица - Али Саттар Атакишиев
Две жизни - Леонид Луков
Водил поезда машинист - Виктор Жилин
Мишка, Серёга и я - Юрий Победоносцев
В мире танца - Роман Тихомиров, Фахри Мустафаев
Рассказы о юности
Длинный день - Рафаил Гольдин
Жизнь сначала - Лев Рудник
Когда деревья были большими - Лев Кулиджанов
Братья Комаровы - Анатолий Вехотко
Чистое небо - Григорий Чухрай
Любушка - Владимир Каплуновский
А если это любовь? - Юлий Райзман
Алые паруса - Александр Птушко
Человек-амфибия - Владимир Чеботарев, Геннадий Казанский

NEW